a year or two/one or two years	一两年(2种)
the Summer Palace	颐和园
depend on	取决于，依靠于
wharf 	码头
fly/ride to sp.	飞到/开车到某地
a six-hour flight/six hours’ flight	六小时的航程（2）
drive	车程，开车n. 
a short distance	短距离 
hardly/rarely/scarcely/seldom	几乎不（2）
go to the movies (AE) go to (see) a movie	去看电影（2）
write home	写信回家 
every other day/week	每隔一天、一星期 
be easy to get on/along with	容易相处（2）
get on/along (well) (with sb.)	和谁相处的好 
make sb captain	选谁当队长 
be keen on (doing ) sth/be keen to do sth	热衷于（做）某事（2）
trustworthy	值得信赖的 
trust sb to do sth	相信某人会做某事 
have trust in sb	对谁有信任 
be strong in doing sth/be strong on sth	善于（做）某事 
be weak in doing sth/be weak on sth 	不善于做某事 
improve	提升v. 
improvement	提升n. 
sb.’s point about sth	某人关于某事的观点 
exercise	锻炼v 
keep fit	保持健美 
lift weights	举重  
weight-lifting	举重运动 
weight-lifter	举重者 
kid	开玩笑 
go roller-skating	去滑滑轮 
hardly ever	几乎从不 
keep in good health	保持健康 
memorable	值得纪念的 
memory	记忆 
memorize	记（v） 
take a trip across America	做横穿美国的旅行 
indeed	真正地，的确 
set out/off/leave from A for B	从A出发去B（3） 
take/pick up No.10 Highway	选择10号公路（2） 
run all the way from A to B	从A一路前行到B 
drive through … as far as …	开车穿过A直到B 
New Orleans	新奥尔良 
Los Angeles	洛杉矶 
Louisiana	路易斯安那 
San Antonio 	圣安东尼奥 
Texas 	德克萨斯 
tiring	累人的 
tired	感到累的 
spin	旋转
period	一段时间，时期 
face north	朝向北面 
in/during daytime/day-time	在白天（2） 
at nighttime/night-time	在黑夜（2） 
in other words	换言之 
sunlight	阳光 
darkness	黑暗 
sunrise	日出 
sunset	日落 
in an orbit	在轨道中 
journey	旅行 
lean	倾斜，依靠 
giant	巨大的 
super hot gases	超级热气 
heat	热量 
heat sth	加热某样东西 
heated	加热了的 
be surrounded by	被什么围绕 
surrounding	周边环境 
the family of planets	行星家族 
the solar system	太阳系 
solar	太阳的 
solar power	太阳能 
Mercury	水星 
Venus	金星 
the Earth	地球 
Mars	火星 
Jupiter	木星 
Saturn	土星 
Uranus	天王星 
Neptune	海王星 
liquid	液体 
be close to	离什么地方近 
rock	岩石 
rocky	坚硬的，岩石般的 
beyond	在什么之上，超越了什么 
How long does it take from the school to your home?	从学校到你家要花多少时间? 
The reason is that he didn’t make it on time.	原因是他没有及时赶到。
That is why we are late	这就是为什么我们迟到了。 
My suggestion is that you should set off earlier.	我的建议是你们早点出发。
We should exercise more.	我们应该多做练习。
diameter	半径 
circle	圈住 
circle	圈 
surface	表面 
average	平均的 
satellite	卫星 
one’s way to do sth/one’s way of doing sth	某人做某事的方式（2） 

